#
# # # # #     #
  #           #
  # # # # # # #
    #     #
    #     #
    #     # # #
              $
